[{"c0": "1",
  "c1": "2",
  "c2": "3",
  "c3": "",
  "c4": "",
  "c5": "",
  "c6": "",
  "c7": "",
  "c8": "",
  "c9": "",
  "c10": "",
  "c11": "",
  "c12": "",
  "c13": "",
  "c14": "",
  "c19": "",
  "c15": "",
  "c16": "",
  "c17": "",
  "c18": "",
  "c20": "",
  "c21": "",
  "c22": "",
  "c23": "",
  "c24": "",
  "c25": "",
  "c29": "",
  "c30": "",
  "c31": "",
  "c34": "",
  "c32": "",
  "c33": ""
}]
